R 1600 900
NO ./srcs/textures/kamen.xpm
SO ./srcs/textures/plitke.xpm
WE ./srcs/textures/21.xpm
EA ./srcs/textures/crete_floor2.xpm
FL ./srcs/textures/greystone.xpm

S ./srcs/textures/pillar.xpm
C 20,20,70

         11111111111111111111111
        1000000000112020202020201111111111111111111111111111111111111111111111111111111111
        101100000111000000000000000000000000000000000000000040000000000000000000020000001
        1001000000000000000000001111111111111111111111111111111111111111111111111111111111
111111111011000001110020202020201111111111111111112222222222222222222220000000000000000021
10000000001100000111011111111111110000000000000000000000000000000000000011111111111111111
11110111111111011100000010001    102222222222222222222222111111111111111
11110111111111011101010010201    1000000000000000000000001
11000000110101011100000000001    1111111111111111111110111
1000000000000001100000010001     150000000000000000000001
10000000000000001101010010001    1000000000000000000000001
11000001110101011111011112N2111  1000000000000000000001111
11112111 1110101 101111010001   100000000000000020000011
11111111 1111111 111111111111    1111111111110111111111
                                     10000000000001
                                      100000000001
                                       1000000001
                                        122202221
                                        122202221
                                        111111111